0,0,0,0,0,0,0,200,200,0,0,0,0,200,0,0,0,0,0,0
0,0,0,0,0,0,0,0,200,0,0,0,0,200,0,0,0,0,0,0
0,0,0,0,0,0,0,0,200,0,200,0,0,200,0,0,200,0,0,0
0,0,0,0,200,0,0,0,200,0,200,0,0,200,0,0,200,0,0,0
0,0,0,0,200,0,0,0,200,0,200,0,0,200,0,0,200,0,0,0
0,0,0,0,200,0,0,0,200,0,200,0,0,200,0,0,200,0,0,0
0,0,0,0,200,0,0,0,200,0,200,0,0,200,0,0,200,0,0,0
0,0,0,0,200,0,0,0,200,0,200,0,0,200,0,0,200,0,0,0
0,0,0,0,200,0,0,0,200,0,200,0,0,200,0,0,200,0,0,0
0,0,0,0,200,0,0,200,200,0,200,0,0,200,0,0,200,0,0,0
0,0,0,0,200,0,0,200,0,0,200,0,0,200,0,0,200,0,0,0
0,0,0,0,200,0,0,200,0,0,200,0,0,200,0,0,200,0,0,0
0,0,0,0,200,0,0,200,0,0,200,0,0,200,0,0,200,0,0,0
0,0,0,0,200,0,0,0,0,0,200,0,0,0,0,0,200,0,0,0
0,0,0,0,200,0,0,0,0,0,200,0,0,0,200,200,200,0,0,0
200,200,200,200,200,200,200,200,200,200,200,200,200,200,200,200,200,0,0,0
0,0,0,0,0,0,0,0,0,0,0,0,0,0,0,0,0,0,0,0
0,0,200,200,200,200,200,200,200,200,200,200,200,200,200,200,200,200,200,200
0,0,0,0,0,0,0,0,0,0,0,0,0,0,0,0,0,0,0,0
0,0,0,0,0,0,0,0,0,0,0,0,0,0,0,0,0,0,0,0